# Color code
#   X - WHITE
#   0 - BLACK
#   1 - GREEN
#   2 - BLUE
#   3 - RED
#   4 - ORANGE
#   5 - YELLOW
#   6 - PURPLE
#   | - Boundary
|                                                                    |
|                                                                    |
|                                                                    |
|                                                                W   |
|                                                                1   |
|                                                                    |
|                      2                                        2    |
|                                                                    |
|                              W                                    3|
|    11                 66     5                                     |
|            W     44                                           2    |
|          44244    66                                               |
|                                                                   3|
|   2222                           22                           2    |
|        3333333   555       3333      2121         11111           3|
|                                                                    |
|                                                                    |
|00000000000000000000000000000000000000000000000000000000000000000000|
|00000000000000000000000000000000000000000000000000000000000000000000|
|00000000000000000000000000000000000000000000000000000000000000000000|
