# Color code
#   X - WHITE
#   0 - BLACK
#   1 - PURPLE
#   2 - BLUE
#   3 - GREEN
#   4 - YELLOW
#   5 - ORANGE
#   6 - RED
#   | - Boundary
|                                  |
|                                  |
|                                  |
|                                  |
|                                  |
|                                  |
|                                  |
|                                  |
|                                  |
|                                  |
|                                  |
|                                  |
|    11                 66     5   |
|                  44              |
|          44244    66                  |
|                                 |
|   2222                           |
|                                  |
|0000000000000000000000000000000000|
|0000000000000000000000000000000000|
